mlx.core.fast.layer_norm.md	core/fast/mlx.core.fast.layer_norm.md
mlx.core.fast.metal_kernel.md	core/fast/mlx.core.fast.metal_kernel.md
mlx.core.fast.rms_norm.md	core/fast/mlx.core.fast.rms_norm.md
mlx.core.fast.rope.md	core/fast/mlx.core.fast.rope.md
mlx.core.fast.scaled_dot_product_attention.md	core/fast/mlx.core.fast.scaled_dot_product_attention.md
mlx.core.fft.fft.md	core/fft/mlx.core.fft.fft.md
mlx.core.fft.fft2.md	core/fft/mlx.core.fft.fft2.md
mlx.core.fft.fftn.md	core/fft/mlx.core.fft.fftn.md
mlx.core.fft.ifft.md	core/fft/mlx.core.fft.ifft.md
mlx.core.fft.ifft2.md	core/fft/mlx.core.fft.ifft2.md
mlx.core.fft.ifftn.md	core/fft/mlx.core.fft.ifftn.md
mlx.core.fft.irfft.md	core/fft/mlx.core.fft.irfft.md
mlx.core.fft.irfft2.md	core/fft/mlx.core.fft.irfft2.md
mlx.core.fft.irfftn.md	core/fft/mlx.core.fft.irfftn.md
mlx.core.fft.rfft.md	core/fft/mlx.core.fft.rfft.md
mlx.core.fft.rfft2.md	core/fft/mlx.core.fft.rfft2.md
mlx.core.fft.rfftn.md	core/fft/mlx.core.fft.rfftn.md
mlx.core.linalg.cholesky.md	core/linalg/mlx.core.linalg.cholesky.md
mlx.core.linalg.cholesky_inv.md	core/linalg/mlx.core.linalg.cholesky_inv.md
mlx.core.linalg.cross.md	core/linalg/mlx.core.linalg.cross.md
mlx.core.linalg.eigh.md	core/linalg/mlx.core.linalg.eigh.md
mlx.core.linalg.eigvalsh.md	core/linalg/mlx.core.linalg.eigvalsh.md
mlx.core.linalg.inv.md	core/linalg/mlx.core.linalg.inv.md
mlx.core.linalg.lu.md	core/linalg/mlx.core.linalg.lu.md
mlx.core.linalg.lu_factor.md	core/linalg/mlx.core.linalg.lu_factor.md
mlx.core.linalg.norm.md	core/linalg/mlx.core.linalg.norm.md
mlx.core.linalg.pinv.md	core/linalg/mlx.core.linalg.pinv.md
mlx.core.linalg.qr.md	core/linalg/mlx.core.linalg.qr.md
mlx.core.linalg.solve.md	core/linalg/mlx.core.linalg.solve.md
mlx.core.linalg.solve_triangular.md	core/linalg/mlx.core.linalg.solve_triangular.md
mlx.core.linalg.svd.md	core/linalg/mlx.core.linalg.svd.md
mlx.core.linalg.tri_inv.md	core/linalg/mlx.core.linalg.tri_inv.md
mlx.core.distributed.Group.md	core/distributed/mlx.core.distributed.Group.md
mlx.core.distributed.all_gather.md	core/distributed/mlx.core.distributed.all_gather.md
mlx.core.distributed.all_sum.md	core/distributed/mlx.core.distributed.all_sum.md
mlx.core.distributed.init.md	core/distributed/mlx.core.distributed.init.md
mlx.core.distributed.is_available.md	core/distributed/mlx.core.distributed.is_available.md
mlx.core.distributed.recv.md	core/distributed/mlx.core.distributed.recv.md
mlx.core.distributed.recv_like.md	core/distributed/mlx.core.distributed.recv_like.md
mlx.core.distributed.send.md	core/distributed/mlx.core.distributed.send.md
mlx.core.random.bernoulli.md	core/random/mlx.core.random.bernoulli.md
mlx.core.random.categorical.md	core/random/mlx.core.random.categorical.md
mlx.core.random.gumbel.md	core/random/mlx.core.random.gumbel.md
mlx.core.random.key.md	core/random/mlx.core.random.key.md
mlx.core.random.laplace.md	core/random/mlx.core.random.laplace.md
mlx.core.random.multivariate_normal.md	core/random/mlx.core.random.multivariate_normal.md
mlx.core.random.normal.md	core/random/mlx.core.random.normal.md
mlx.core.random.permutation.md	core/random/mlx.core.random.permutation.md
mlx.core.random.randint.md	core/random/mlx.core.random.randint.md
mlx.core.random.seed.md	core/random/mlx.core.random.seed.md
mlx.core.random.split.md	core/random/mlx.core.random.split.md
mlx.core.random.truncated_normal.md	core/random/mlx.core.random.truncated_normal.md
mlx.core.random.uniform.md	core/random/mlx.core.random.uniform.md
mlx.core.metal.device_info.md	core/metal/mlx.core.metal.device_info.md
mlx.core.metal.is_available.md	core/metal/mlx.core.metal.is_available.md
mlx.core.metal.start_capture.md	core/metal/mlx.core.metal.start_capture.md
mlx.core.metal.stop_capture.md	core/metal/mlx.core.metal.stop_capture.md
mlx.core.array.T.md	core/array/mlx.core.array.T.md
mlx.core.array.abs.md	core/array/mlx.core.array.abs.md
mlx.core.array.all.md	core/array/mlx.core.array.all.md
mlx.core.array.any.md	core/array/mlx.core.array.any.md
mlx.core.array.argmax.md	core/array/mlx.core.array.argmax.md
mlx.core.array.argmin.md	core/array/mlx.core.array.argmin.md
mlx.core.array.astype.md	core/array/mlx.core.array.astype.md
mlx.core.array.at.md	core/array/mlx.core.array.at.md
mlx.core.array.conj.md	core/array/mlx.core.array.conj.md
mlx.core.array.cos.md	core/array/mlx.core.array.cos.md
mlx.core.array.cummax.md	core/array/mlx.core.array.cummax.md
mlx.core.array.cummin.md	core/array/mlx.core.array.cummin.md
mlx.core.array.cumprod.md	core/array/mlx.core.array.cumprod.md
mlx.core.array.cumsum.md	core/array/mlx.core.array.cumsum.md
mlx.core.array.diag.md	core/array/mlx.core.array.diag.md
mlx.core.array.diagonal.md	core/array/mlx.core.array.diagonal.md
mlx.core.array.dtype.md	core/array/mlx.core.array.dtype.md
mlx.core.array.exp.md	core/array/mlx.core.array.exp.md
mlx.core.array.flatten.md	core/array/mlx.core.array.flatten.md
mlx.core.array.item.md	core/array/mlx.core.array.item.md
mlx.core.array.itemsize.md	core/array/mlx.core.array.itemsize.md
mlx.core.array.log.md	core/array/mlx.core.array.log.md
mlx.core.array.log10.md	core/array/mlx.core.array.log10.md
mlx.core.array.log1p.md	core/array/mlx.core.array.log1p.md
mlx.core.array.log2.md	core/array/mlx.core.array.log2.md
mlx.core.array.logcumsumexp.md	core/array/mlx.core.array.logcumsumexp.md
mlx.core.array.logsumexp.md	core/array/mlx.core.array.logsumexp.md
mlx.core.array.max.md	core/array/mlx.core.array.max.md
mlx.core.array.mean.md	core/array/mlx.core.array.mean.md
mlx.core.array.min.md	core/array/mlx.core.array.min.md
mlx.core.array.moveaxis.md	core/array/mlx.core.array.moveaxis.md
mlx.core.array.nbytes.md	core/array/mlx.core.array.nbytes.md
mlx.core.array.ndim.md	core/array/mlx.core.array.ndim.md
mlx.core.array.prod.md	core/array/mlx.core.array.prod.md
mlx.core.array.reciprocal.md	core/array/mlx.core.array.reciprocal.md
mlx.core.array.reshape.md	core/array/mlx.core.array.reshape.md
mlx.core.array.round.md	core/array/mlx.core.array.round.md
mlx.core.array.rsqrt.md	core/array/mlx.core.array.rsqrt.md
mlx.core.array.shape.md	core/array/mlx.core.array.shape.md
mlx.core.array.sin.md	core/array/mlx.core.array.sin.md
mlx.core.array.size.md	core/array/mlx.core.array.size.md
mlx.core.array.split.md	core/array/mlx.core.array.split.md
mlx.core.array.sqrt.md	core/array/mlx.core.array.sqrt.md
mlx.core.array.square.md	core/array/mlx.core.array.square.md
mlx.core.array.squeeze.md	core/array/mlx.core.array.squeeze.md
mlx.core.array.std.md	core/array/mlx.core.array.std.md
mlx.core.array.sum.md	core/array/mlx.core.array.sum.md
mlx.core.array.swapaxes.md	core/array/mlx.core.array.swapaxes.md
mlx.core.array.tolist.md	core/array/mlx.core.array.tolist.md
mlx.core.array.transpose.md	core/array/mlx.core.array.transpose.md
mlx.core.array.var.md	core/array/mlx.core.array.var.md
mlx.core.array.view.md	core/array/mlx.core.array.view.md
mlx.core.array.md	core/array/mlx.core.array.md
mlx.core.Device.md	core/mlx.core.Device.md
mlx.core.Dtype.md	core/mlx.core.Dtype.md
mlx.core.DtypeCategory.md	core/mlx.core.DtypeCategory.md
mlx.core.abs.md	core/mlx.core.abs.md
mlx.core.add.md	core/mlx.core.add.md
mlx.core.addmm.md	core/mlx.core.addmm.md
mlx.core.all.md	core/mlx.core.all.md
mlx.core.allclose.md	core/mlx.core.allclose.md
mlx.core.any.md	core/mlx.core.any.md
mlx.core.arange.md	core/mlx.core.arange.md
mlx.core.arccos.md	core/mlx.core.arccos.md
mlx.core.arccosh.md	core/mlx.core.arccosh.md
mlx.core.arcsin.md	core/mlx.core.arcsin.md
mlx.core.arcsinh.md	core/mlx.core.arcsinh.md
mlx.core.arctan.md	core/mlx.core.arctan.md
mlx.core.arctan2.md	core/mlx.core.arctan2.md
mlx.core.arctanh.md	core/mlx.core.arctanh.md
mlx.core.argmax.md	core/mlx.core.argmax.md
mlx.core.argmin.md	core/mlx.core.argmin.md
mlx.core.argpartition.md	core/mlx.core.argpartition.md
mlx.core.argsort.md	core/mlx.core.argsort.md
mlx.core.array_equal.md	core/mlx.core.array_equal.md
mlx.core.as_strided.md	core/mlx.core.as_strided.md
mlx.core.async_eval.md	core/mlx.core.async_eval.md
mlx.core.atleast_1d.md	core/mlx.core.atleast_1d.md
mlx.core.atleast_2d.md	core/mlx.core.atleast_2d.md
mlx.core.atleast_3d.md	core/mlx.core.atleast_3d.md
mlx.core.bitwise_and.md	core/mlx.core.bitwise_and.md
mlx.core.bitwise_invert.md	core/mlx.core.bitwise_invert.md
mlx.core.bitwise_or.md	core/mlx.core.bitwise_or.md
mlx.core.bitwise_xor.md	core/mlx.core.bitwise_xor.md
mlx.core.block_masked_mm.md	core/mlx.core.block_masked_mm.md
mlx.core.broadcast_arrays.md	core/mlx.core.broadcast_arrays.md
mlx.core.broadcast_to.md	core/mlx.core.broadcast_to.md
mlx.core.ceil.md	core/mlx.core.ceil.md
mlx.core.clear_cache.md	core/mlx.core.clear_cache.md
mlx.core.clip.md	core/mlx.core.clip.md
mlx.core.compile.md	core/mlx.core.compile.md
mlx.core.concatenate.md	core/mlx.core.concatenate.md
mlx.core.conj.md	core/mlx.core.conj.md
mlx.core.conjugate.md	core/mlx.core.conjugate.md
mlx.core.contiguous.md	core/mlx.core.contiguous.md
mlx.core.conv1d.md	core/mlx.core.conv1d.md
mlx.core.conv2d.md	core/mlx.core.conv2d.md
mlx.core.conv3d.md	core/mlx.core.conv3d.md
mlx.core.conv_general.md	core/mlx.core.conv_general.md
mlx.core.conv_transpose1d.md	core/mlx.core.conv_transpose1d.md
mlx.core.conv_transpose2d.md	core/mlx.core.conv_transpose2d.md
mlx.core.conv_transpose3d.md	core/mlx.core.conv_transpose3d.md
mlx.core.convolve.md	core/mlx.core.convolve.md
mlx.core.cos.md	core/mlx.core.cos.md
mlx.core.cosh.md	core/mlx.core.cosh.md
mlx.core.cummax.md	core/mlx.core.cummax.md
mlx.core.cummin.md	core/mlx.core.cummin.md
mlx.core.cumprod.md	core/mlx.core.cumprod.md
mlx.core.cumsum.md	core/mlx.core.cumsum.md
mlx.core.custom_function.md	core/mlx.core.custom_function.md
mlx.core.default_device.md	core/mlx.core.default_device.md
mlx.core.default_stream.md	core/mlx.core.default_stream.md
mlx.core.degrees.md	core/mlx.core.degrees.md
mlx.core.dequantize.md	core/mlx.core.dequantize.md
mlx.core.diag.md	core/mlx.core.diag.md
mlx.core.diagonal.md	core/mlx.core.diagonal.md
mlx.core.disable_compile.md	core/mlx.core.disable_compile.md
mlx.core.divide.md	core/mlx.core.divide.md
mlx.core.divmod.md	core/mlx.core.divmod.md
mlx.core.einsum.md	core/mlx.core.einsum.md
mlx.core.einsum_path.md	core/mlx.core.einsum_path.md
mlx.core.enable_compile.md	core/mlx.core.enable_compile.md
mlx.core.equal.md	core/mlx.core.equal.md
mlx.core.erf.md	core/mlx.core.erf.md
mlx.core.erfinv.md	core/mlx.core.erfinv.md
mlx.core.eval.md	core/mlx.core.eval.md
mlx.core.exp.md	core/mlx.core.exp.md
mlx.core.expand_dims.md	core/mlx.core.expand_dims.md
mlx.core.expm1.md	core/mlx.core.expm1.md
mlx.core.export_function.md	core/mlx.core.export_function.md
mlx.core.export_to_dot.md	core/mlx.core.export_to_dot.md
mlx.core.exporter.md	core/mlx.core.exporter.md
mlx.core.eye.md	core/mlx.core.eye.md
mlx.core.finfo.md	core/mlx.core.finfo.md
mlx.core.flatten.md	core/mlx.core.flatten.md
mlx.core.floor.md	core/mlx.core.floor.md
mlx.core.floor_divide.md	core/mlx.core.floor_divide.md
mlx.core.full.md	core/mlx.core.full.md
mlx.core.gather_mm.md	core/mlx.core.gather_mm.md
mlx.core.gather_qmm.md	core/mlx.core.gather_qmm.md
mlx.core.get_active_memory.md	core/mlx.core.get_active_memory.md
mlx.core.get_cache_memory.md	core/mlx.core.get_cache_memory.md
mlx.core.get_peak_memory.md	core/mlx.core.get_peak_memory.md
mlx.core.grad.md	core/mlx.core.grad.md
mlx.core.greater.md	core/mlx.core.greater.md
mlx.core.greater_equal.md	core/mlx.core.greater_equal.md
mlx.core.hadamard_transform.md	core/mlx.core.hadamard_transform.md
mlx.core.identity.md	core/mlx.core.identity.md
mlx.core.imag.md	core/mlx.core.imag.md
mlx.core.import_function.md	core/mlx.core.import_function.md
mlx.core.inner.md	core/mlx.core.inner.md
mlx.core.isclose.md	core/mlx.core.isclose.md
mlx.core.isfinite.md	core/mlx.core.isfinite.md
mlx.core.isinf.md	core/mlx.core.isinf.md
mlx.core.isnan.md	core/mlx.core.isnan.md
mlx.core.isneginf.md	core/mlx.core.isneginf.md
mlx.core.isposinf.md	core/mlx.core.isposinf.md
mlx.core.issubdtype.md	core/mlx.core.issubdtype.md
mlx.core.jvp.md	core/mlx.core.jvp.md
mlx.core.kron.md	core/mlx.core.kron.md
mlx.core.left_shift.md	core/mlx.core.left_shift.md
mlx.core.less.md	core/mlx.core.less.md
mlx.core.less_equal.md	core/mlx.core.less_equal.md
mlx.core.linspace.md	core/mlx.core.linspace.md
mlx.core.load.md	core/mlx.core.load.md
mlx.core.log.md	core/mlx.core.log.md
mlx.core.log10.md	core/mlx.core.log10.md
mlx.core.log1p.md	core/mlx.core.log1p.md
mlx.core.log2.md	core/mlx.core.log2.md
mlx.core.logaddexp.md	core/mlx.core.logaddexp.md
mlx.core.logcumsumexp.md	core/mlx.core.logcumsumexp.md
mlx.core.logical_and.md	core/mlx.core.logical_and.md
mlx.core.logical_not.md	core/mlx.core.logical_not.md
mlx.core.logical_or.md	core/mlx.core.logical_or.md
mlx.core.logsumexp.md	core/mlx.core.logsumexp.md
mlx.core.matmul.md	core/mlx.core.matmul.md
mlx.core.max.md	core/mlx.core.max.md
mlx.core.maximum.md	core/mlx.core.maximum.md
mlx.core.mean.md	core/mlx.core.mean.md
mlx.core.meshgrid.md	core/mlx.core.meshgrid.md
mlx.core.min.md	core/mlx.core.min.md
mlx.core.minimum.md	core/mlx.core.minimum.md
mlx.core.moveaxis.md	core/mlx.core.moveaxis.md
mlx.core.multiply.md	core/mlx.core.multiply.md
mlx.core.nan_to_num.md	core/mlx.core.nan_to_num.md
mlx.core.negative.md	core/mlx.core.negative.md
mlx.core.new_stream.md	core/mlx.core.new_stream.md
mlx.core.not_equal.md	core/mlx.core.not_equal.md
mlx.core.ones.md	core/mlx.core.ones.md
mlx.core.ones_like.md	core/mlx.core.ones_like.md
mlx.core.outer.md	core/mlx.core.outer.md
mlx.core.pad.md	core/mlx.core.pad.md
mlx.core.partition.md	core/mlx.core.partition.md
mlx.core.power.md	core/mlx.core.power.md
mlx.core.prod.md	core/mlx.core.prod.md
mlx.core.put_along_axis.md	core/mlx.core.put_along_axis.md
mlx.core.quantize.md	core/mlx.core.quantize.md
mlx.core.quantized_matmul.md	core/mlx.core.quantized_matmul.md
mlx.core.radians.md	core/mlx.core.radians.md
mlx.core.real.md	core/mlx.core.real.md
mlx.core.reciprocal.md	core/mlx.core.reciprocal.md
mlx.core.remainder.md	core/mlx.core.remainder.md
mlx.core.repeat.md	core/mlx.core.repeat.md
mlx.core.reset_peak_memory.md	core/mlx.core.reset_peak_memory.md
mlx.core.reshape.md	core/mlx.core.reshape.md
mlx.core.right_shift.md	core/mlx.core.right_shift.md
mlx.core.roll.md	core/mlx.core.roll.md
mlx.core.round.md	core/mlx.core.round.md
mlx.core.rsqrt.md	core/mlx.core.rsqrt.md
mlx.core.save.md	core/mlx.core.save.md
mlx.core.save_gguf.md	core/mlx.core.save_gguf.md
mlx.core.save_safetensors.md	core/mlx.core.save_safetensors.md
mlx.core.savez.md	core/mlx.core.savez.md
mlx.core.savez_compressed.md	core/mlx.core.savez_compressed.md
mlx.core.set_cache_limit.md	core/mlx.core.set_cache_limit.md
mlx.core.set_default_device.md	core/mlx.core.set_default_device.md
mlx.core.set_default_stream.md	core/mlx.core.set_default_stream.md
mlx.core.set_memory_limit.md	core/mlx.core.set_memory_limit.md
mlx.core.set_wired_limit.md	core/mlx.core.set_wired_limit.md
mlx.core.sigmoid.md	core/mlx.core.sigmoid.md
mlx.core.sign.md	core/mlx.core.sign.md
mlx.core.sin.md	core/mlx.core.sin.md
mlx.core.sinh.md	core/mlx.core.sinh.md
mlx.core.slice.md	core/mlx.core.slice.md
mlx.core.slice_update.md	core/mlx.core.slice_update.md
mlx.core.softmax.md	core/mlx.core.softmax.md
mlx.core.sort.md	core/mlx.core.sort.md
mlx.core.split.md	core/mlx.core.split.md
mlx.core.sqrt.md	core/mlx.core.sqrt.md
mlx.core.square.md	core/mlx.core.square.md
mlx.core.squeeze.md	core/mlx.core.squeeze.md
mlx.core.stack.md	core/mlx.core.stack.md
mlx.core.std.md	core/mlx.core.std.md
mlx.core.stop_gradient.md	core/mlx.core.stop_gradient.md
mlx.core.stream.md	core/mlx.core.stream.md
mlx.core.subtract.md	core/mlx.core.subtract.md
mlx.core.sum.md	core/mlx.core.sum.md
mlx.core.swapaxes.md	core/mlx.core.swapaxes.md
mlx.core.synchronize.md	core/mlx.core.synchronize.md
mlx.core.take.md	core/mlx.core.take.md
mlx.core.take_along_axis.md	core/mlx.core.take_along_axis.md
mlx.core.tan.md	core/mlx.core.tan.md
mlx.core.tanh.md	core/mlx.core.tanh.md
mlx.core.tensordot.md	core/mlx.core.tensordot.md
mlx.core.tile.md	core/mlx.core.tile.md
mlx.core.topk.md	core/mlx.core.topk.md
mlx.core.trace.md	core/mlx.core.trace.md
mlx.core.transpose.md	core/mlx.core.transpose.md
mlx.core.tri.md	core/mlx.core.tri.md
mlx.core.tril.md	core/mlx.core.tril.md
mlx.core.triu.md	core/mlx.core.triu.md
mlx.core.unflatten.md	core/mlx.core.unflatten.md
mlx.core.value_and_grad.md	core/mlx.core.value_and_grad.md
mlx.core.var.md	core/mlx.core.var.md
mlx.core.view.md	core/mlx.core.view.md
mlx.core.vjp.md	core/mlx.core.vjp.md
mlx.core.vmap.md	core/mlx.core.vmap.md
mlx.core.where.md	core/mlx.core.where.md
mlx.core.zeros.md	core/mlx.core.zeros.md
mlx.core.zeros_like.md	core/mlx.core.zeros_like.md
mlx.nn.losses.binary_cross_entropy.md	nn/losses/mlx.nn.losses.binary_cross_entropy.md
mlx.nn.losses.cosine_similarity_loss.md	nn/losses/mlx.nn.losses.cosine_similarity_loss.md
mlx.nn.losses.cross_entropy.md	nn/losses/mlx.nn.losses.cross_entropy.md
mlx.nn.losses.gaussian_nll_loss.md	nn/losses/mlx.nn.losses.gaussian_nll_loss.md
mlx.nn.losses.hinge_loss.md	nn/losses/mlx.nn.losses.hinge_loss.md
mlx.nn.losses.huber_loss.md	nn/losses/mlx.nn.losses.huber_loss.md
mlx.nn.losses.kl_div_loss.md	nn/losses/mlx.nn.losses.kl_div_loss.md
mlx.nn.losses.l1_loss.md	nn/losses/mlx.nn.losses.l1_loss.md
mlx.nn.losses.log_cosh_loss.md	nn/losses/mlx.nn.losses.log_cosh_loss.md
mlx.nn.losses.margin_ranking_loss.md	nn/losses/mlx.nn.losses.margin_ranking_loss.md
mlx.nn.losses.mse_loss.md	nn/losses/mlx.nn.losses.mse_loss.md
mlx.nn.losses.nll_loss.md	nn/losses/mlx.nn.losses.nll_loss.md
mlx.nn.losses.smooth_l1_loss.md	nn/losses/mlx.nn.losses.smooth_l1_loss.md
mlx.nn.losses.triplet_loss.md	nn/losses/mlx.nn.losses.triplet_loss.md
mlx.nn.init.constant.md	nn/init/mlx.nn.init.constant.md
mlx.nn.init.glorot_normal.md	nn/init/mlx.nn.init.glorot_normal.md
mlx.nn.init.glorot_uniform.md	nn/init/mlx.nn.init.glorot_uniform.md
mlx.nn.init.he_normal.md	nn/init/mlx.nn.init.he_normal.md
mlx.nn.init.he_uniform.md	nn/init/mlx.nn.init.he_uniform.md
mlx.nn.init.identity.md	nn/init/mlx.nn.init.identity.md
mlx.nn.init.normal.md	nn/init/mlx.nn.init.normal.md
mlx.nn.init.uniform.md	nn/init/mlx.nn.init.uniform.md
mlx.nn.ALiBi.md	nn/mlx.nn.ALiBi.md
mlx.nn.AvgPool1d.md	nn/mlx.nn.AvgPool1d.md
mlx.nn.AvgPool2d.md	nn/mlx.nn.AvgPool2d.md
mlx.nn.AvgPool3d.md	nn/mlx.nn.AvgPool3d.md
mlx.nn.BatchNorm.md	nn/mlx.nn.BatchNorm.md
mlx.nn.Conv1d.md	nn/mlx.nn.Conv1d.md
mlx.nn.Conv2d.md	nn/mlx.nn.Conv2d.md
mlx.nn.Conv3d.md	nn/mlx.nn.Conv3d.md
mlx.nn.ConvTranspose1d.md	nn/mlx.nn.ConvTranspose1d.md
mlx.nn.ConvTranspose2d.md	nn/mlx.nn.ConvTranspose2d.md
mlx.nn.ConvTranspose3d.md	nn/mlx.nn.ConvTranspose3d.md
mlx.nn.Dropout.md	nn/mlx.nn.Dropout.md
mlx.nn.Dropout2d.md	nn/mlx.nn.Dropout2d.md
mlx.nn.Dropout3d.md	nn/mlx.nn.Dropout3d.md
mlx.nn.Embedding.md	nn/mlx.nn.Embedding.md
mlx.nn.GRU.md	nn/mlx.nn.GRU.md
mlx.nn.GroupNorm.md	nn/mlx.nn.GroupNorm.md
mlx.nn.HardShrink.md	nn/mlx.nn.HardShrink.md
mlx.nn.HardTanh.md	nn/mlx.nn.HardTanh.md
mlx.nn.InstanceNorm.md	nn/mlx.nn.InstanceNorm.md
mlx.nn.LSTM.md	nn/mlx.nn.LSTM.md
mlx.nn.LayerNorm.md	nn/mlx.nn.LayerNorm.md
mlx.nn.LeakyReLU.md	nn/mlx.nn.LeakyReLU.md
mlx.nn.Linear.md	nn/mlx.nn.Linear.md
mlx.nn.LogSigmoid.md	nn/mlx.nn.LogSigmoid.md
mlx.nn.LogSoftmax.md	nn/mlx.nn.LogSoftmax.md
mlx.nn.MaxPool1d.md	nn/mlx.nn.MaxPool1d.md
mlx.nn.MaxPool2d.md	nn/mlx.nn.MaxPool2d.md
mlx.nn.MaxPool3d.md	nn/mlx.nn.MaxPool3d.md
mlx.nn.Module.apply.md	nn/mlx.nn.Module.apply.md
mlx.nn.Module.apply_to_modules.md	nn/mlx.nn.Module.apply_to_modules.md
mlx.nn.Module.children.md	nn/mlx.nn.Module.children.md
mlx.nn.Module.eval.md	nn/mlx.nn.Module.eval.md
mlx.nn.Module.filter_and_map.md	nn/mlx.nn.Module.filter_and_map.md
mlx.nn.Module.freeze.md	nn/mlx.nn.Module.freeze.md
mlx.nn.Module.leaf_modules.md	nn/mlx.nn.Module.leaf_modules.md
mlx.nn.Module.load_weights.md	nn/mlx.nn.Module.load_weights.md
mlx.nn.Module.modules.md	nn/mlx.nn.Module.modules.md
mlx.nn.Module.named_modules.md	nn/mlx.nn.Module.named_modules.md
mlx.nn.Module.parameters.md	nn/mlx.nn.Module.parameters.md
mlx.nn.Module.save_weights.md	nn/mlx.nn.Module.save_weights.md
mlx.nn.Module.set_dtype.md	nn/mlx.nn.Module.set_dtype.md
mlx.nn.Module.state.md	nn/mlx.nn.Module.state.md
mlx.nn.Module.train.md	nn/mlx.nn.Module.train.md
mlx.nn.Module.trainable_parameters.md	nn/mlx.nn.Module.trainable_parameters.md
mlx.nn.Module.training.md	nn/mlx.nn.Module.training.md
mlx.nn.Module.unfreeze.md	nn/mlx.nn.Module.unfreeze.md
mlx.nn.Module.update.md	nn/mlx.nn.Module.update.md
mlx.nn.Module.update_modules.md	nn/mlx.nn.Module.update_modules.md
mlx.nn.MultiHeadAttention.md	nn/mlx.nn.MultiHeadAttention.md
mlx.nn.QuantizedEmbedding.md	nn/mlx.nn.QuantizedEmbedding.md
mlx.nn.QuantizedLinear.md	nn/mlx.nn.QuantizedLinear.md
mlx.nn.RMSNorm.md	nn/mlx.nn.RMSNorm.md
mlx.nn.RNN.md	nn/mlx.nn.RNN.md
mlx.nn.RoPE.md	nn/mlx.nn.RoPE.md
mlx.nn.Sequential.md	nn/mlx.nn.Sequential.md
mlx.nn.SinusoidalPositionalEncoding.md	nn/mlx.nn.SinusoidalPositionalEncoding.md
mlx.nn.Softsign.md	nn/mlx.nn.Softsign.md
mlx.nn.Transformer.md	nn/mlx.nn.Transformer.md
mlx.nn.Upsample.md	nn/mlx.nn.Upsample.md
mlx.nn.average_gradients.md	nn/mlx.nn.average_gradients.md
mlx.nn.celu.md	nn/mlx.nn.celu.md
mlx.nn.elu.md	nn/mlx.nn.elu.md
mlx.nn.gelu.md	nn/mlx.nn.gelu.md
mlx.nn.gelu_approx.md	nn/mlx.nn.gelu_approx.md
mlx.nn.gelu_fast_approx.md	nn/mlx.nn.gelu_fast_approx.md
mlx.nn.glu.md	nn/mlx.nn.glu.md
mlx.nn.hard_shrink.md	nn/mlx.nn.hard_shrink.md
mlx.nn.hard_tanh.md	nn/mlx.nn.hard_tanh.md
mlx.nn.hardswish.md	nn/mlx.nn.hardswish.md
mlx.nn.leaky_relu.md	nn/mlx.nn.leaky_relu.md
mlx.nn.log_sigmoid.md	nn/mlx.nn.log_sigmoid.md
mlx.nn.log_softmax.md	nn/mlx.nn.log_softmax.md
mlx.nn.mish.md	nn/mlx.nn.mish.md
mlx.nn.prelu.md	nn/mlx.nn.prelu.md
mlx.nn.quantize.md	nn/mlx.nn.quantize.md
mlx.nn.relu.md	nn/mlx.nn.relu.md
mlx.nn.relu6.md	nn/mlx.nn.relu6.md
mlx.nn.selu.md	nn/mlx.nn.selu.md
mlx.nn.sigmoid.md	nn/mlx.nn.sigmoid.md
mlx.nn.silu.md	nn/mlx.nn.silu.md
mlx.nn.softmax.md	nn/mlx.nn.softmax.md
mlx.nn.softmin.md	nn/mlx.nn.softmin.md
mlx.nn.softplus.md	nn/mlx.nn.softplus.md
mlx.nn.softshrink.md	nn/mlx.nn.softshrink.md
mlx.nn.step.md	nn/mlx.nn.step.md
mlx.nn.tanh.md	nn/mlx.nn.tanh.md
mlx.nn.value_and_grad.md	nn/mlx.nn.value_and_grad.md
mlx.optimizers.AdaDelta.md	optimizers/mlx.optimizers.AdaDelta.md
mlx.optimizers.Adafactor.md	optimizers/mlx.optimizers.Adafactor.md
mlx.optimizers.Adagrad.md	optimizers/mlx.optimizers.Adagrad.md
mlx.optimizers.Adam.md	optimizers/mlx.optimizers.Adam.md
mlx.optimizers.AdamW.md	optimizers/mlx.optimizers.AdamW.md
mlx.optimizers.Adamax.md	optimizers/mlx.optimizers.Adamax.md
mlx.optimizers.Lion.md	optimizers/mlx.optimizers.Lion.md
mlx.optimizers.MultiOptimizer.md	optimizers/mlx.optimizers.MultiOptimizer.md
mlx.optimizers.Optimizer.apply_gradients.md	optimizers/mlx.optimizers.Optimizer.apply_gradients.md
mlx.optimizers.Optimizer.init.md	optimizers/mlx.optimizers.Optimizer.init.md
mlx.optimizers.Optimizer.state.md	optimizers/mlx.optimizers.Optimizer.state.md
mlx.optimizers.Optimizer.update.md	optimizers/mlx.optimizers.Optimizer.update.md
mlx.optimizers.RMSprop.md	optimizers/mlx.optimizers.RMSprop.md
mlx.optimizers.SGD.md	optimizers/mlx.optimizers.SGD.md
mlx.optimizers.clip_grad_norm.md	optimizers/mlx.optimizers.clip_grad_norm.md
mlx.optimizers.cosine_decay.md	optimizers/mlx.optimizers.cosine_decay.md
mlx.optimizers.exponential_decay.md	optimizers/mlx.optimizers.exponential_decay.md
mlx.optimizers.join_schedules.md	optimizers/mlx.optimizers.join_schedules.md
mlx.optimizers.linear_schedule.md	optimizers/mlx.optimizers.linear_schedule.md
mlx.optimizers.step_decay.md	optimizers/mlx.optimizers.step_decay.md
mlx.utils.tree_flatten.md	utils/mlx.utils.tree_flatten.md
mlx.utils.tree_map.md	utils/mlx.utils.tree_map.md
mlx.utils.tree_map_with_path.md	utils/mlx.utils.tree_map_with_path.md
mlx.utils.tree_reduce.md	utils/mlx.utils.tree_reduce.md
mlx.utils.tree_unflatten.md	utils/mlx.utils.tree_unflatten.md
